aɪ|aɪ.wav
vaɪəlɪn|vaɪəlɪn.wav
bɜːtʃ|bɜːtʃ.wav
ɡɹuːpə|ɡɹuːpə.wav
hɪbɪskəs|hɪbɪskəs.wav
ɹəʊp|ɹəʊp.wav
piəni|piəni.wav
ɒlɪv|ɒlɪv.wav
eɪpɹɪkɒt|eɪpɹɪkɒt.wav
zɛɹəs|zɛɹəs.wav
ɛbənɪ|ɛbənɪ.wav
heɪzɪlnʌt|heɪzɪlnʌt.wav
tiːk|tiːk.wav
ʌmbɹɛlə|ʌmbɹɛlə.wav
ɹæmbjuːtən|ɹæmbjuːtən.wav
miəkæt|miəkæt.wav
ɪ|ɪ.wav
dʒækfɹuːt|dʒækfɹuːt.wav
ʒ|ʒ.wav
niːdəl|niːdəl.wav
tɹʌmpɪt|tɹʌmpɪt.wav
zɛbuː|zɛbuː.wav
ʌɡni|ʌɡni.wav
aɪsbɜːɡ|aɪsbɜːɡ.wav
bæskɪt|bæskɪt.wav
nɒnaɪ|nɒnaɪ.wav
ɹəʊən|ɹəʊən.wav
juːəkɑːɹi|juːəkɑːɹi.wav
lɑːtʃ|lɑːtʃ.wav
taɪɡə|taɪɡə.wav
kæpɒk|kæpɒk.wav
fɒksɡlʌv|fɒksɡlʌv.wav
kwɪlt|kwɪlt.wav
fɪɡ|fɪɡ.wav
sneɪk|sneɪk.wav
pɔːpɔː|pɔːpɔː.wav
klaʊnfɪʃ|klaʊnfɪʃ.wav
sælmənbəɹi|sælmənbəɹi.wav
kæktəs|kæktəs.wav
ʊə|ʊə.wav
liːmə|liːmə.wav
wʊlfbəɹi|wʊlfbəɹi.wav
oʊ|oʊ.wav
maʊntɪn|maʊntɪn.wav
zɛbɹəwʊd|zɛbɹəwʊd.wav
kwɪnəʊə|kwɪnəʊə.wav
saɪpɹəs|saɪpɹəs.wav
bɪɡəʊniə|bɪɡəʊniə.wav
wɔːtəlilɪ|wɔːtəlilɪ.wav
zaɪləfəʊn|zaɪləfəʊn.wav
zaɪmiːniə|zaɪmiːniə.wav
meɪpəl|meɪpəl.wav
lædə|lædə.wav
zɛnəps|zɛnəps.wav
dʒækəl|dʒækəl.wav
mɑːməsɛt|mɑːməsɛt.wav
ɹæbɪt|ɹæbɪt.wav
ɹæsbəɹi|ɹæsbəɹi.wav
bluːbɛɹi|bluːbɛɹi.wav
kwɒndɒŋ|kwɒndɒŋ.wav
ɹ|ɹ.wav
ʃ|ʃ.wav
ɹækuːn|ɹækuːn.wav
paɪn|paɪn.wav
mæɡnəʊliə|mæɡnəʊliə.wav
aɪs|aɪs.wav
dɹæɡən|dɹæɡən.wav
laɪən|laɪən.wav
bɹæzɪlnʌt|bɹæzɪlnʌt.wav
tʃ|tʃ.wav
dʒɑː|dʒɑː.wav
ð|ð.wav
kəʊɑːlə|kəʊɑːlə.wav
tjuːnə|tjuːnə.wav
siːhɔːs|siːhɔːs.wav
hɑːp|hɑːp.wav
bɹɒkəli|bɹɒkəli.wav
ɛnvələʊp|ɛnvələʊp.wav
ɡəzɛl|ɡəzɛl.wav
vaɪpəfɪʃ|vaɪpəfɪʃ.wav
pəpaɪə|pəpaɪə.wav
æ|æ.wav
æɹəʊ|æɹəʊ.wav
wɪləʊ|wɪləʊ.wav
kwiːn|kwiːn.wav
ælpækə|ælpækə.wav
uː|uː.wav
nɛkləs|nɛkləs.wav
aɪbɛks|aɪbɛks.wav
fælkən|fælkən.wav
jɛləʊdʒækɪt|jɛləʊdʒækɪt.wav
DS|DS.wav
ɒɹɪndʒ|ɒɹɪndʒ.wav
dɒlfɪn|dɒlfɪn.wav
ɛdɪlweɪs|ɛdɪlweɪs.wav
tuːkən|tuːkən.wav
ɒlmənd|ɒlmənd.wav
l|l.wav
dʒɪŋkɡəʊ|dʒɪŋkɡəʊ.wav
tʃɛɹi|tʃɛɹi.wav
hʌnɪdjuː|hʌnɪdjuː.wav
hɔːs|hɔːs.wav
ɡləʊb|ɡləʊb.wav
tɛlɪskəʊp|tɛlɪskəʊp.wav
tjuːlɪp|tjuːlɪp.wav
z|z.wav
vaɪələt|vaɪələt.wav
m|m.wav
kwɪlbæk|kwɪlbæk.wav
piːtʃ|piːtʃ.wav
ʌniən|ʌniən.wav
kæŋɡəɹuː|kæŋɡəɹuː.wav
əʊləlɪbəɹi|əʊləlɪbəɹi.wav
fɛðə|fɛðə.wav
feɪdʒəʊə|feɪdʒəʊə.wav
ɒktəpəs|ɒktəpəs.wav
zɪpə|zɪpə.wav
vɒlkeɪnəʊ|vɒlkeɪnəʊ.wav
vʌltʃə|vʌltʃə.wav
vəʊvænɡə|vəʊvænɡə.wav
lɑːmə|lɑːmə.wav
flæʃlaɪt|flæʃlaɪt.wav
tændʒiːləʊ|tændʒiːləʊ.wav
jæm|jæm.wav
ɛɡplænt|ɛɡplænt.wav
kɛtəl|kɛtəl.wav
dʒuːnɪpə|dʒuːnɪpə.wav
dɹʌm|dɹʌm.wav
ɡɹeɪpfɹuːt|ɡɹeɪpfɹuːt.wav
læntən|læntən.wav
ɜːtʃɪn|ɜːtʃɪn.wav
n|n.wav
ɹeɪndiə|ɹeɪndiə.wav
pɪænəʊ|pɪænəʊ.wav
hʌklɪbəɹi|hʌklɪbəɹi.wav
ɹɛdbʌd|ɹɛdbʌd.wav
kælæntʃəʊ|kælæntʃəʊ.wav
pæɹəʃuːt|pæɹəʃuːt.wav
sʌnflaʊə|sʌnflaʊə.wav
j|j.wav
ɡæɹɑːnə|ɡæɹɑːnə.wav
jɛləʊteɪl|jɛləʊteɪl.wav
ɹɒkɪt|ɹɒkɪt.wav
vaɪn|vaɪn.wav
spɹuːs|spɹuːs.wav
piːnʌt|piːnʌt.wav
əʊʃən|əʊʃən.wav
ɡɪtɑː|ɡɪtɑː.wav
k|k.wav
sæʊəsəp|sæʊəsəp.wav
kaɪt|kaɪt.wav
kɑːneɪʃən|kɑːneɪʃən.wav
kæʃjuː|kæʃjuː.wav
ə|ə.wav
ɛ|ɛ.wav
ɛksɹeɪtɛtɹə|ɛksɹeɪtɛtɹə.wav
vɪkuːnə|vɪkuːnə.wav
baɪsən|baɪsən.wav
sɪsəz|sɪsəz.wav
dɒɡwʊd|dɒɡwʊd.wav
θ|θ.wav
i|i.wav
iːɡəl|iːɡəl.wav
ɹeɪ|ɹeɪ.wav
ɔː|ɔː.wav
jæk|jæk.wav
hɪkəɹi|hɪkəɹi.wav
eɪkɔːn|eɪkɔːn.wav
dʒæzmɪn|dʒæzmɪn.wav
kweɪl|kweɪl.wav
h|h.wav
wɒmbæt|wɒmbæt.wav
ɔɪ|ɔɪ.wav
pændə|pændə.wav
wɔːlaɪ|wɔːlaɪ.wav
ɪɡluː|ɪɡluː.wav
ʃʌvəl|ʃʌvəl.wav
ɪnkæbəɹi|ɪnkæbəɹi.wav
juːkə|juːkə.wav
ɪə|ɪə.wav
iː|iː.wav
ɛlm|ɛlm.wav
fɪɡtɹiː|fɪɡtɹiː.wav
kʌmkwæt|kʌmkwæt.wav
r|r.wav
e|e.wav
kæntəluːp|kæntəluːp.wav
ɡɑːdiːniə|ɡɑːdiːniə.wav
wiːl|wiːl.wav
mʌnkɪ|mʌnkɪ.wav
ɪlɑːmə|ɪlɑːmə.wav
d|d.wav
kɹænbəɹi|kɹænbəɹi.wav
s|s.wav
əpɒsəm|əpɒsəm.wav
sɪkəmɔː|sɪkəmɔː.wav
wɔːtəfɔːl|wɔːtəfɔːl.wav
f|f.wav
hæməhɛd|hæməhɛd.wav
juːlæn|juːlæn.wav
ævəkɑːdəʊ|ævəkɑːdəʊ.wav
blækbəɹi|blækbəɹi.wav
iːl|iːl.wav
dɹæɡənfɪʃ|dɹæɡənfɪʃ.wav
kiːwiː|kiːwiː.wav
aɪənwʊd|aɪənwʊd.wav
ɡuːsbəɹi|ɡuːsbəɹi.wav
g|g.wav
p|p.wav
eɪ|eɪ.wav
juːzuː|juːzuː.wav
ɪɡjuːɑːnə|ɪɡjuːɑːnə.wav
ɒsəlɒt|ɒsəlɒt.wav
flaʊndə|flaʊndə.wav
fɪlbət|fɪlbət.wav
bæmbuː|bæmbuː.wav
wɒlɹəs|wɒlɹəs.wav
t|t.wav
beɪəbæb|beɪəbæb.wav
nɛst|nɛst.wav
kweɪkɪŋ|kweɪkɪŋ.wav
ɛlɪfənt|ɛlɪfənt.wav
əʊ|əʊ.wav
kændəl|kændəl.wav
b|b.wav
wɔːtəmɛlən|wɔːtəmɛlən.wav
jæŋmeɪ|jæŋmeɪ.wav
dʒɪɹæf|dʒɪɹæf.wav
tændʒəɹiːn|tændʒəɹiːn.wav
dʒɛlɪ|dʒɛlɪ.wav
ɡɛkəʊ|ɡɛkəʊ.wav
bɪlbəɹi|bɪlbəɹi.wav
ɒ|ɒ.wav
pɔːkjuːpaɪn|pɔːkjuːpaɪn.wav
aɪɹɪs|aɪɹɪs.wav
mæŋɡəstiːn|mæŋɡəstiːn.wav
dʒækəɹændə|dʒækəɹændə.wav
ənɛməni|ənɛməni.wav
w|w.wav
njuːt|njuːt.wav
bæɹəkjuːdə|bæɹəkjuːdə.wav
əkeɪʃə|əkeɪʃə.wav
vənɪlə|vənɪlə.wav
næns|næns.wav
dʒʌŋɡəl|dʒʌŋɡəl.wav
ʒiː|ʒiː.wav
ænkə|ænkə.wav
bʌtəflaɪ|bʌtəflaɪ.wav
v|v.wav
a|a.wav
zɪniə|zɪniə.wav
hɛdʒhɒɡ|hɛdʒhɒɡ.wav
vɑːz|vɑːz.wav
laɪlək|laɪlək.wav
dʒ|dʒ.wav
haɪiːnə|haɪiːnə.wav
zɛbɹæfɪʃ|zɛbɹæfɪʃ.wav
nɑːwəl|nɑːwəl.wav
mækədeɪmiə|mækədeɪmiə.wav
kæɹət|kæɹət.wav
ɡwɑːvə|ɡwɑːvə.wav
mʌlbəɹi|mʌlbəɹi.wav
waɪnbəɹi|waɪnbəɹi.wav
tʃiːtə|tʃiːtə.wav
kʌdzuː|kʌdzuː.wav
teɪbəɹi|teɪbəɹi.wav
lɪli|lɪli.wav
lɛmən|lɛmən.wav
dʒæbətɪkɑːbə|dʒæbətɪkɑːbə.wav
flɛmɪŋɡəʊ|flɛmɪŋɡəʊ.wav
ɛksɹeɪ|ɛksɹeɪ.wav
dɒɡ|dɒɡ.wav
jɑːn|jɑːn.wav
ɔːkɪd|ɔːkɪd.wav
ɡ|ɡ.wav
deɪzi|deɪzi.wav
ʌ|ʌ.wav
skʌŋk|skʌŋk.wav
æstə|æstə.wav
nɛktɑːɹiːn|nɛktɑːɹiːn.wav
ɹɛdwʊd|ɹɛdwʊd.wav
æspən|æspən.wav
ɑː|ɑː.wav
dʒæɡwɑː|dʒæɡwɑː.wav
kuːkəbʌɹə|kuːkəbʌɹə.wav
mæɡnɪt|mæɡnɪt.wav
weɪl|weɪl.wav
jəʊjəʊ|jəʊjəʊ.wav
zʌkiːnɪ|zʌkiːnɪ.wav
ɹəʊz|ɹəʊz.wav
liːtʃiː|liːtʃiː.wav
ɡɹeɪp|ɡɹeɪp.wav
ŋ|ŋ.wav
dɪŋɡəʊ|dɪŋɡəʊ.wav
kɪwɑːnəʊ|kɪwɑːnəʊ.wav
pəɹɑːnə|pəɹɑːnə.wav
mɑːlɪn|mɑːlɪn.wav
dʒɛlɪfɪʃ|dʒɛlɪfɪʃ.wav
fɜː|fɜː.wav
ʌɡli|ʌɡli.wav
dɹæɡənfɹuːt|dɹæɡənfɹuːt.wav
djʊəɹiən|djʊəɹiən.wav
nɑːsɪsəs|nɑːsɪsəs.wav
ɛldəbəɹi|ɛldəbəɹi.wav
kwɒkə|kwɒkə.wav
pɑːm|pɑːm.wav
juː|juː.wav
siːdə|siːdə.wav
bənɑːnə|bənɑːnə.wav
æpəl|æpəl.wav
əkaɪ|əkaɪ.wav
sæpədɪlə|sæpədɪlə.wav
iːmjuː|iːmjuː.wav
lɒbstə|lɒbstə.wav
pɛŋɡwɪn|pɛŋɡwɪn.wav
əʊk|əʊk.wav
iə|iə.wav
kæt|kæt.wav
hɒli|hɒli.wav
tæpiə|tæpiə.wav
ʊ|ʊ.wav
zɛbɹə|zɛbɹə.wav
fɹɒɡ|fɹɒɡ.wav
mæŋɡəʊ|mæŋɡəʊ.wav
stɹɔːbəɹi|stɹɔːbəɹi.wav
ɪmbɛ|ɪmbɛ.wav
tæməɹɪnd|tæməɹɪnd.wav
mæɹɪɡəʊld|mæɹɪɡəʊld.wav
nʌtmɛɡ|nʌtmɛɡ.wav
hæmə|hæmə.wav
kəʊlə|kəʊlə.wav
lɒŋɡən|lɒŋɡən.wav
kɔɪ|kɔɪ.wav
kwɪns|kwɪns.wav
wɒlnʌt|wɒlnʌt.wav
kɒɹəl|kɒɹəl.wav
dæfədɪl|dæfədɪl.wav
ɜː|ɜː.wav
deɪt|deɪt.wav
eə|eə.wav
dʒuːdʒuːb|dʒuːdʒuːb.wav
aʊ|aʊ.wav